"filename", "language", "Go Module File", "Go", "Go Checksum File", "comment", "blank", "total"
"/home/goprojects/github.com/holy-shit/leetcode-study/config/config.go", "Go", 0, 30, 0, 0, 3, 33
"/home/goprojects/github.com/holy-shit/leetcode-study/dao/dao.go", "Go", 0, 57, 0, 0, 11, 68
"/home/goprojects/github.com/holy-shit/leetcode-study/ggdb/data/datafile.go", "Go", 0, 100, 0, 0, 19, 119
"/home/goprojects/github.com/holy-shit/leetcode-study/ggdb/data/log_record.go", "Go", 0, 81, 0, 0, 25, 106
"/home/goprojects/github.com/holy-shit/leetcode-study/ggdb/db.go", "Go", 0, 293, 0, 0, 44, 337
"/home/goprojects/github.com/holy-shit/leetcode-study/ggdb/errors.go", "Go", 0, 9, 0, 0, 3, 12
"/home/goprojects/github.com/holy-shit/leetcode-study/ggdb/fio/file_io.go", "Go", 0, 36, 0, 0, 10, 46
"/home/goprojects/github.com/holy-shit/leetcode-study/ggdb/fio/io_manager.go", "Go", 0, 18, 0, 0, 8, 26
"/home/goprojects/github.com/holy-shit/leetcode-study/ggdb/index/btree.go", "Go", 0, 54, 0, 0, 10, 64
"/home/goprojects/github.com/holy-shit/leetcode-study/ggdb/index/index.go", "Go", 0, 42, 0, 0, 13, 55
"/home/goprojects/github.com/holy-shit/leetcode-study/ggdb/internal/bloom/bloom.go", "Go", 0, 50, 0, 0, 10, 60
"/home/goprojects/github.com/holy-shit/leetcode-study/ggdb/internal/sync/spinlock.go", "Go", 0, 27, 0, 0, 7, 34
"/home/goprojects/github.com/holy-shit/leetcode-study/ggdb/options.go", "Go", 0, 22, 0, 0, 9, 31
"/home/goprojects/github.com/holy-shit/leetcode-study/go.mod", "Go Module File", 3, 0, 0, 0, 3, 6
"/home/goprojects/github.com/holy-shit/leetcode-study/go.sum", "Go Checksum File", 0, 0, 2, 0, 1, 3
"/home/goprojects/github.com/holy-shit/leetcode-study/main.go", "Go", 0, 49, 0, 0, 6, 55
"/home/goprojects/github.com/holy-shit/leetcode-study/model/model.go", "Go", 0, 7, 0, 0, 2, 9
"/home/goprojects/github.com/holy-shit/leetcode-study/service/user_service.go", "Go", 0, 115, 0, 0, 15, 130
"/home/goprojects/github.com/holy-shit/leetcode-study/utils/spinlock.go", "Go", 0, 27, 0, 0, 7, 34
"/home/goprojects/github.com/holy-shit/leetcode-study/utils/utils.go", "Go", 0, 95, 0, 0, 20, 115
"Total", "-", 3, 1112, 2, 0, 226, 1343